The Gate
An Interactive Fiction by Christian Schulz
Release 1 / Serial number 160221 / Inform 7 build 6M62 (I6/v6.33 lib 6/12N) SD

Lower Hall (South).
You are in the lower hall south.  You can see lower hall north ot your north, and the upper landing above you.

>s
*** The End ***

Would you like to RESTART, RESTORE a saved game, QUIT or UNDO the last command?

* * *

The Gate
An Interactive Fiction by Christian Schulz
Release 1 / Serial number 160221 / Inform 7 build 6M62 (I6/v6.33 lib 6/12N) SD

Lower Hall (South).
You are in the lower hall south.  You can see lower hall north ot your north, and the upper landing above you.

>n
Upper Landing

>d
Lower Hall (South)

>n
Lower Hall (North)
You can see an office door here.

>e
(first opening the office door)
It isn't something you can open.

>e
(first opening the office door)
It isn't something you can open.

>kick door
You forcefully push your foot into the office door, and it swings open with a loud BANG.

>e
Office
You can see an office door here.

* * *

>e
(first opening the office door)
It isn't something you can open.

>kick door
(the office door)
You forcefully push your foot into the office door, and it swings open with a loud BANG.

>e
Office
You can see an office door, an office elevator door and a call button here.

>n
(first opening the office elevator door)
It isn't something you can open.

>turn on button
You switch the office call button on.

>l
Office
You can see an office door, an elevator door and an office call button here.

>n
Elevator
You can see an elevator door here.

>s
Office
You can see an elevator door, an office door and an office call button here.

>switch button
You switch the office call button off.

>n
(first opening the elevator door)
It isn't something you can open.

>switch button
You switch the office call button on.

>switch button
You switch the office call button off.

>switch button
You switch the office call button on.

>n
Elevator
You can see an elevator door here.

* * *

>n
(first opening the office elevator door)
It isn't something you can open.

>turn on call button
You switch the call button on.

>n
Elevator
You can see an office elevator door, an exit button, a basement button and a station button here.

* * *

>l
Elevator
You can see an office elevator door, an exit button, a basement button and a station button here.

>s
Basement
You can see a call button and a basement elevator door here.

>n
Elevator
You can see an office elevator door, an exit button, a basement button and a station button here.

>s
Basement
You can see a call button and a basement elevator door here.

>turn off call button
You switch the call button off.

>n
(first opening the basement elevator door)
It isn't something you can open.

>turn on basement button
You can't see any such thing.

>turn on call button
You switch the call button on.

* * *

>n
Elevator
You can see an office elevator door, an exit button, a basement button and a station button here.

>turn off basement button
You switch the basement button off.

>s
Basement
You can see a call button and a basement elevator door here.

* * *

>n
Lower Hall (North)
You can see an office door here.

>kick door
(the office door)
You forcefully push your foot into the office door, and it swings open with a loud BANG.

* * *

>n
(first opening the office elevator door)
It isn't something you can open.

>turn on call
You switch the call button on.

>n
Elevator
You can see an office elevator door, an exit button, a basement button and a station button here.

* * *

>turn off basement
You switch the basement button off.

* * *

>n
(first opening the office elevator door)
It isn't something you can open.

>kick door
Which do you mean, the station door unlocking, the elevator door opening, the office door or the office elevator door?

>office elevator door
You forcefully push your foot into the office elevator door, but it refuses to give.

>push button
Nothing obvious happens.

>turn on button
You switch the call button on.

>n
Elevator
You can see an office elevator door, an exit button, a basement button, an elevator card slot and a station button here.

>turn on slot
You switch the elevator card slot on.

>turn on station
(the station button)

>d
You can't go that way.

>e
You can't go that way.

>s
Long Corridor
You can see a call button and a station elevator door here.

>d
Station Entrance
You can see a station entrance door and a station entrance card slot here.

>n
(first opening the station entrance door)
(first unlocking the station entrance door)
You lack a key that fits the station entrance door.

>turn on card slot
You switch the station entrance card slot on.

>n
(first opening the station entrance door)

Darkness
It is pitch dark, and you can't see a thing.

>w
Station Hall (Southwest)

>w
Lab

>e
Station Hall (Southwest)

>n
Station Hall (Northwest)

>nb
That's not a verb I recognise.

>n
Generator Room
You can see a main generator (on which are a red knob, green knob, blue knob and a power switch) here.

>x generator
(the main generator)
On the main generator are a red knob, green knob, blue knob and a power switch.

>turn on knob
Which do you mean, the red knob, green knob or blue knob?

>red
You switch the red knob on.

>turn on switch
The auxiliary generator turns off. Blah blah.

You switch the power switch on.

>turn on switch
The auxiliary generator turns off. Blah blah.

That's already on.

* * *

>n
Upper Landing

>e
You can't go that way.

>d
Lower Hall (South)

>e
You can't go that way.

>n
Lower Hall (North)
You can see an office door here.

* * *

>n
(first opening the office elevator door)
It isn't something you can open.

>push button
Nothing obvious happens.

>n
(first opening the office elevator door)
It isn't something you can open.

>turn on button
You switch the call button on.

>n
Elevator
You can see an office elevator door, an exit button, a basement button and a station button here.

>turn on basement button
*** Run-time problem P2: Tried to change the south exit of the Elevator, but it led to a door, not a room.

* * *

The Gate
An Interactive Fiction by Christian Schulz
Release 1 / Serial number 160221 / Inform 7 build 6M62 (I6/v6.33 lib 6/12N) SD

Lower Hall (South).
You are in the lower hall south.  You can see lower hall north ot your north, and the upper landing above you.

I beg your pardon?

I beg your pardon?

* * *

The Gate
An Interactive Fiction by Christian Schulz
Release 1 / Serial number 160221 / Inform 7 build 6M62 (I6/v6.33 lib 6/12N) SD

Lower Hall (South).
You are in the lower hall south.  You can see lower hall north ot your north, and the upper landing above you.

>look
Upper Hall

>go
You'll have to say which compass direction to go in.

>south
*** The End ***

Would you like to RESTART, RESTORE a saved game, QUIT or UNDO the last command?

>restart
The Gate
An Interactive Fiction by Christian Schulz
Release 1 / Serial number 160221 / Inform 7 build 6M62 (I6/v6.33 lib 6/12N) SD

Upper Hall

>north
Upper Landing

>east
You can't go that way.

>north
You can't go that way.

>up
You can't go that way.

* * *

The Gate
An Interactive Fiction by Christian Schulz
Release 1 / Serial number 160221 / Inform 7 build 6M62 (I6/v6.33 lib 6/12N) SD

Lower Hall (South).
You are in the lower hall south.  You can see lower hall north ot your north, and the upper landing above you.

>north
Lower Hall (North)
You are north of the lower hall.  You see the lower hall to your south, and a door to your east leading to the office.

You can see an office door here.

>down
Lower Hall (South).
You are in the lower hall south.  You can see lower hall north ot your north.

You can see You here.

* * *

>north
Lower Hall (North)
You are north of the lower hall.  You see the lower hall to your south, and a door to your east leading to the office.

You can see an office door here.

>open east
You must name something more substantial.

>east
(first opening the office door)
It isn't something you can open.

>kick east
You must name something more substantial.

>kick door
(the office door)
You forcefully push your foot into the office door, and it swings open with a loud BANG.

>east
Office
You are in the office. You see a door to your west leading to the lower hall north.

You see a door to your east leading to the office.

You can also see an office elevator door and a call button here.