Switch Test
An Interactive Fiction by Christian Schulz
Release 1 / Serial number 160221 / Inform 7 build 6L38 (I6/v6.33 lib 6/12N) SD

Darkness
It is pitch dark, and you can't see a thing.

>l
Terrifying Basement
You can see a red switch and a blue switch here.

>flip switch
You switch the light switch off.

It is now pitch dark in here!

>l
Darkness
It is pitch dark, and you can't see a thing.

>flip switch
You switch the light switch on.

Terrifying Basement
You can see a light switch here.

>u
Upstairs

>l
Upstairs

>d
Terrifying Basement
You can see a light switch here.

>u
Upstairs

>flip switch
You can't see any such thing.

* * *

>flip switch
You switch the light switch off.

It is now pitch dark in here!

>flip switch
relation of things to effects: controlling relation
Controlling relates various things to various effects:
  The light switch  >=>  the basement light
DEBUG 1DEBUG 2relation of things to effects: controlling relation
Controlling relates various things to various effects:
  The light switch  >=>  the basement light

Terrifying Basement
You can see a light switch and a basement light here.

* * *

>l
Terrifying Basement
You can see a red switch and a blue switch here.

>l
Terrifying Basement
You can see a red switch and a blue switch here.

1, 1

>l
Terrifying Basement
You can see a red switch and a blue switch here.

0, 1

I beg your pardon?

>l
Terrifying Basement
You can see a red switch and a blue switch here.

* * *

>l
Terrifying Basement
You can see a red switch and a blue switch here.

0, 1

>u
Upstairs
You can't reach into the Terrifying Basement.

You can't reach into the Terrifying Basement.

You can't reach into the Terrifying Basement.

>l
Upstairs

>l
Upstairs

>d
Terrifying Basement
You can see a red switch and a blue switch here.

>l
Terrifying Basement
You can see a red switch and a blue switch here.

>l
Terrifying Basement
You can see a red switch and a blue switch here.

* * *

>l
Terrifying Basement
You can see a red switch and a blue switch here.

0, 1

>l
Terrifying Basement
You can see a red switch and a blue switch here.

1, 1

>flip red switch
You switch the red switch off.

0, 0

>look
Terrifying Basement
You can see a red switch and a blue switch here.

1, 0

>l
Terrifying Basement
You can see a red switch and a blue switch here.

0, 0

>l
Terrifying Basement
You can see a red switch and a blue switch here.

1, 0

>flip blue switch
You switch the blue switch on.

1, 0

>flip blue switch
You switch the blue switch off.

1, 0

>flip blue switch
You switch the blue switch on.

1, 0

>l
Terrifying Basement
You can see a red switch and a blue switch here.

2, 1

>l
Terrifying Basement
You can see a red switch and a blue switch here.

1, 0

>l
Terrifying Basement
You can see a red switch and a blue switch here.

2, 1

* * *

>l
Terrifying Basement
You can see a red switch and a blue switch here.

>flip red switch
You switch the red switch off.

It is now pitch dark in here!

>l
Darkness
It is pitch dark, and you can't see a thing.

>l
Darkness
It is pitch dark, and you can't see a thing.

>flip blue switch
You switch the blue switch on.

Terrifying Basement
You can see a red switch and a blue switch here.

>z
Time passes.

It is now pitch dark in here!

>z
Time passes.

Terrifying Basement
You can see a red switch and a blue switch here.

>z
Time passes.

It is now pitch dark in here!

* * *

>z
Time passes.

Terrifying Basement
You can see a red switch and a blue switch here.

>flip red switch
You switch the red switch on.

>l
Terrifying Basement
You can see a red switch and a blue switch here.

* * *

Switch Test
An Interactive Fiction by Christian Schulz
Release 1 / Serial number 160221 / Inform 7 build 6L38 (I6/v6.33 lib 6/12N) SD

Darkness
It is pitch dark, and you can't see a thing.

>help
That's not a verb I recognise.

* * *

Switch Test
An Interactive Fiction by Christian Schulz
Release 1 / Serial number 160221 / Inform 7 build 6L38 (I6/v6.33 lib 6/12N) SD

Darkness
It is pitch dark, and you can't see a thing.

>flip switch
You switch the blue switch on.

It is now pitch dark in here!

>l
Terrifying Basement
You can see a light switch here.

>flip switch
You switch the light switch on.

* * *

>flip switch
You switch the blue switch on.

It is now pitch dark in here!

>flip switch
Which do you mean, the red switch or the blue switch?

>l
Darkness
It is pitch dark, and you can't see a thing.

* * *

>l
Darkness
It is pitch dark, and you can't see a thing.

* * *

>control
That's not a verb I recognise.

* * *

>flip switch
Which do you mean, the red switch or the blue switch?

>flip switch
You switch the light switch on.

Terrifying Basement
You can see a light switch here.

>flip switch
You switch the light switch off.

It is now pitch dark in here!

* * *

>flip switch
Which do you mean, the red switch or the blue switch?

>blue
You switch the blue switch off.

Terrifying Basement
You can see a red switch and a blue switch here.

>flip red switch
You switch the red switch off.

It is now pitch dark in here!

>flip red switch
You switch the red switch on.

Terrifying Basement
You can see a red switch and a blue switch here.

* * *

>flip switch
You switch the blue switch on.

It is now pitch dark in here!

>;l
That's not a verb I recognise.

>l
Terrifying Basement
You can see a light switch here.

* * *

Switch Test
An Interactive Fiction by Christian Schulz
Release 1 / Serial number 160221 / Inform 7 build 6L38 (I6/v6.33 lib 6/12N) SD

Darkness
It is pitch dark, and you can't see a thing.

>flip the switch
It isn't something you can switch.

You switch the light switch on.

It is now pitch dark in here!

>flip the switch
It isn't something you can switch.

You switch the light switch off.

Terrifying Basement
You can see a light switch here.

* * *

Switch Test
An Interactive Fiction by Christian Schulz
Release 1 / Serial number 160221 / Inform 7 build 6L38 (I6/v6.33 lib 6/12N) SD

Darkness
It is pitch dark, and you can't see a thing.

I beg your pardon?

>flip switch
That's already off.

You switch the light switch on.

It is now pitch dark in here!

>flip switch
You switch the light switch off.

Terrifying Basement
You can see a light switch here.

* * *

Switch Test
An Interactive Fiction by Christian Schulz
Release 1 / Serial number 160221 / Inform 7 build 6L38 (I6/v6.33 lib 6/12N) SD

Darkness
It is pitch dark, and you can't see a thing.

>flip red switch
You switch the red switch on.

Terrifying Basement
You can see a red switch and a blue switch here.

>flip red switch
You switch the red switch off.

>flip red switch
You switch the red switch off.

It is now pitch dark in here!

* * *

>flip red switch
You switch the red switch on.

Terrifying Basement
You can see a red switch and a blue switch here.

>flip red switch
You switch the red switch off.

It is now pitch dark in here!

>flip blue switch
You switch the blue switch off.

>flip red switch
You switch the red switch on.

>flip blue switch
You switch the blue switch on.

Terrifying Basement
You can see a red switch and a blue switch here.

>flip blue switch
You switch the blue switch off.

It is now pitch dark in here!

>flip blue switch
You switch the blue switch on.

Terrifying Basement
You can see a red switch and a blue switch here.

* * *

>flip blue switch
You switch the blue switch off.

It is now pitch dark in here!

>flip red switch
You switch the red switch off.

>flip blue switch
You switch the blue switch on.

>flip red switch
You switch the red switch on.

Terrifying Basement
You can see a red switch and a blue switch here.

>flip blue switch
You switch the blue switch on.

It is now pitch dark in here!

>flip blue switch
You switch the blue switch off.

Terrifying Basement
You can see a red switch and a blue switch here.

* * *

>flip red switch
You switch the red switch off.

>flip blue switch
You switch the blue switch on.

It is now pitch dark in here!

>flip red switch
You switch the red switch off.

Terrifying Basement
You can see a red switch and a blue switch here.

>flip blue switch
You switch the blue switch off.

It is now pitch dark in here!

>flip red switch
You switch the red switch on.

Terrifying Basement
You can see a red switch and a blue switch here.

>x red switch
The red switch is currently switched on.

>x blue switch
The blue switch is currently switched off.

>flip blue switch
You switch the blue switch on.

It is now pitch dark in here!

>flip blue switch
You switch the blue switch off.

>flip red switch
You switch the red switch on.

Terrifying Basement
You can see a red switch and a blue switch here.

* * *

>flip blue switch
You switch the blue switch off.

>flip blue switch
You switch the blue switch on.

>flip blue switch
You switch the blue switch off.